##########################
#@........##..........q..#
#...........#........#####
###......................#
#........................#
#...........#......s.....#
#.....s.....#............#
#...........#............#
#...........#............#
#...........z............#
##########################