##########################
#@........##..........s.B#
#...........###......#####
###.........s............#
#........................#
#...........#......s.....#
#.....s.....#............#
#...........#............#
#...........#............#
#...........k............#
##########################