##########################
#@..........#...s.....B..#
#...........#.....s......#
#...........#........#####
#...........#.......#....#
#...........#........k..C#
#...................#....#
#...........#........#####
#...........#......q.....#
#........................#
##########################