##########################
#@.......................#
####.D################D###
#M.......................#
####################..####
#......................M.#
####..####################
#M.......................#
###############.D..#######
#...g....................#
##########################