##########################
#@.......................#
#....##.......##.........#
#....##..q....##......z..#
#........................#
#.........q..............#
#........................#
#....##.......##.........#
#....##...z...##......b..#
##########################